########################xxxxxxxxxxxx########################
########################xxxxxxxxxxxx########################
#####........###########xxxxxxxxxxxx###########........#####
#####.######....########xxxxxxxxxxxx########....######.#####
#####.#########....#########^##$#########....#########.#####
#####...###x######....######.##.######....######x###...#####
#######.###x#########........##........#########x###.#######
#####...###xxxxx############################xxxxx###...#####
#####.################################################.#####
#####.###################xxxxxxxxxxx##################.#####
#####.............########################.............#####
#################.########################.#################
#################.#######...........######.#################
#################.#######.#########.######.#################
###...............#######.####x####.######...............###
###.#####################.####x####.####################.###
###.#####################.####x####.####################.###
###.......................####x####......................###
############################################################
############################################################