#^##########################################################
#.##########################################################
#......................................................#####
######################################################.#####
######################################################.#####
##.....................................................#####
##.#########################################################
##.#########################################################
##.....................................................#####
######################################################.#####
######################################################.#####
##.....................................................#####
##.#########################################################
##.##################$................######################
##.##################################.######################
##.....................##############.###xxxxxxxxxxxxxxxxxxx
######################.##############.###xxxxxxxxxxxxxxxxxxx
######################................###xxxxxxxxxxxxxxxxxxx
#########################################xxxxxxxxxxxxxxxxxxx
xxxxxxxxxxxxxxxxxxx######################xxxxxxxxxxxxxxxxxxx