############################################################
############################################################
#####........#########.......##.......#########........#####
#####.######....######.#####.##.#####.######....######.#####
#####.#########....###.#####^##$#####.###....#########.#####
#####...##########.....##############.....##########...#####
#######.############################################.#######
#####...############################################...#####
#####.########................................########.#####
#####.########.##############################.########.#####
#####...######.####xxxxxxxxxxxxxxxxxxxxx#####.######...#####
#######.######.##############xx##############.######.#######
#######.######.##############xx##############.######.#######
#######.######.............##xx##.............######.#######
#######.##################.##xx##.##################.#######
#######....###########.....##xx##.....###########....#######
##########.###########.##############.###########.##########
xxxx######.............##############.............#######xxx
xxxx#####################################################xxx
xxxx#####################################################xxx