############################################################
############################################################
#####^................................................######
#####################################################.######
#####################################################.######
####.....................................#####xxx####.######
####.###################################.#####xxx####.######
####.###################################.#####xxx####.######
####.####################$...............############.######
####.################################################.######
####.......#####.......#####.......######.......#####.######
##########.#####.#####.#####.#####.######.#####.#####.######
xxxxxx####.#####.#####.#####.#####.######.#####.#####.######
xxxxxx####.#####.#####.#####.#####.######.#####.#####.######
xxxxxx####.#####.#####.#####.#####.######.#####.#####.######
xxxxxx####.#####.#####.#####.#####.######.#####.#####.######
xxxxxx####.#####.#####.#####.#####.######.#####.#####.######
xxxxxx####.......#####.......#####........#####.......######
xxxxxx######################################################
xxxxxx######################################################