##^#########################################################
##.#########################################################
##.##.....................................................##
##.##.###################################################.##
##.##.###################################################.##
##.##.##...............................................##.##
##.##.##.#############################################.##.##
##.##.##.#############################################.##.##
##.##.##.##$........................................##.##.##
##.##.##.##########################################.##.##.##
##.##.##.##########################################.##.##.##
##.##.##............................................##.##.##
##.##.################################################.##.##
##.##.################################################.##.##
##.##..................................................##.##
##.######################################################.##
##.######################################################.##
##........................................................##
############################################################
############################################################

This is how a map file can look. The only requirments are, that it is as 60 by 20 map and that it has a spawner (^) and an end ($).

To use a map you have to include it in a map_list file, this way you can filter out the maps you like for example.